11111111111111111
1P0CCECCC10010001
1C01E000000C00001
1C1001C0000111011
11111111111111111