111111111111111111111
1P01C000010C100011001
1000000C0000000010001
1011000000C1001000001
1C0110111111111C101E1
111111111111111111111