111111111111111111
1P00C00CC100100001
10010000000C000001
1C1001C00001110111
100111111C00000E11
111111111111111111