111111111111111111111
1P00C0000100100011001
1001000000000000C0001
1010010111111111E0001
100110011000000010001
111111111111111111111
