111111111111111111111
1P00C0000100100001001
100100C0000000000C001
10100000000E000111001
10011C111000000010001
111111111111111111111