1111111111111111
111001P0C11C1011
11E0001000101001
11100000C0000111
1000000000000001
1000000000000001
1111111111111111